1111111
100CEC1
10C0101
1110CP1
1111111